{
	"tileset" : "chemin.png",
	"terrain" : [
		[2, 2, 2, 2, 2, 2, 9, 10, 11,  2,  2,  2,  2,  2,  2],
		[2, 2, 2, 2, 2, 2, 9, 10, 11,  2,  2,  2,  2,  2,  2],
		[2, 2, 2, 2, 2, 2, 9, 10, 11,  2,  2,  2,  2,  2,  2],
		[2, 2, 2, 1, 2, 2, 9, 10, 11,  2,  2,  2,  2,  2,  2],
		[2, 2, 2, 2, 2, 2, 9, 10, 11,  2,  2,  2,  2,  2,  2],
		[2, 2, 2, 2, 2, 2, 9, 10, 11,  2,  2,  2,  2,  2,  2],
		[6, 6, 6, 6, 6, 6, 10, 10,  8,  6,  6,  6,  6,  6,  6],
		[10, 10, 10, 10, 10, 10, 10, 10, 10, 10, 10, 10, 10, 10, 10],
		[14, 14, 14, 14, 14, 14, 10, 10, 12, 14, 14, 14, 14, 14, 14],
		[2, 2, 2, 2, 2, 2, 9, 10, 11,  2,  2,  2,  2,  2,  2],
		[2, 2, 2, 2, 2, 2, 9, 10, 11,  2,  2,  2,  2,  2,  2],
		[2, 2, 2, 2, 2, 2, 9, 10, 11,  2,  2,  2,  2,  2,  2],
		[2, 2, 2, 2, 2, 2, 9, 10, 11,  2,  2,  2,  2,  2,  2],
		[2, 2, 2, 2, 2, 2, 9, 10, 11,  2,  2,  2,  2,  2,  2],
		[2, 2, 2, 2, 2, 2, 9, 10, 11,  2,  2,  2,  2,  2,  2]
	]
}
